#.######.#
#.######.#
#.######.#
#........#
###.##.###
###.##.###
#...##...#
#.######.#
#.######.#
#..####..#
\robot 1 9
\robot 8 9
